NO ./grass_test.png

   
SO ./grass_test.png

WE ./grass_test.png
EA ./grass_test.png

F 220,100,70


C 225,30,0

11111111111111111111111111
10000000000000000000000001
10000000000000000000000001
10000000000000000000000001
10000000001110000000000001
10000000001 10000000000001
1000000000111000000000000111111
1000000000000000000000000000001
1000000000000000000000000000001
1000000000000000000000000000001
1000000000000000000000000000001
1111111111111111111111111111111
