NO ./grass_test.png
SO ./grass_test.png
WE ./grass_test.png
EA ./grass_test.png

F 220,100,70
C 225,30,0

1111111111111111111111111111
1000000000000000000000000101
1000000000000000000000000111
10000000000000000000000001
11111111111111111111111111